a la	a la
Abbas	abas
Achar	at͡ʃa
Adli	adli
Admiralty	ɛdməɹəti
Adni	adni
ah	a
Ahmad	amad
Aiman	a͡iman
Airport	ɛpɔt
Aisha	a͡iʃa
Akmal	akmal
Albert	ɛlbət
Ali	ali
Aliwal	aliwal
Aljunied	ald͡ʒunid
Allenby	ɛlənbi
Amil	amil
Amina	amina
Amirah	amiɹa
Ammar	amar
Amoy	amoi
Ampang	ampaŋ
Ang	aŋ
Angin	aŋgin
Anika	anika
Aniket	aniket
Anish	aniʃ
Anishka	aniʃka
Anita 	anita
Ann Siang	ansiaŋ
Anusha	anuʃa
Apam	apam
Aqilah	akila
Arab	ɛrəb
Armenian	aminiən
Arnav	aɹnav
Arul	aɹul
Ashok	aʃok
Ashraf	aʃɹaf
Assam	asam
Avenue	ɛvənju
ayam	ajam
ayer	aje
Baghdad	bagdad
Bahru	baɹu
bak	bʼaɹ̆k̚
Bakau	baka͡u
Bakso	bakso
Balakrishnan	balakɹiʃnan
Bali	bali
Balik	balik
Ban	ban
Bangau	baŋa͡u
Bangkit	baŋkit
bao	p̚aw
Bartley	batli
Basah	basa
Batisah	batisa
Batok	batok
batu	batu
Bay	be
Bayfront	befɹan
Bayshore	beʃɔ
Beauty	bjuti
Bedok	bədoʔ
Bee	bi
beehoon	biː huːn
begedil	bəˈgədɪl
belakang	bəlakaŋ
Belilios	bɛlilios
Bencoolen	bɛnkulən
Bendemeer	bɛndəmiə
Besar	bəsa
Bilis	bilis
Biryani	biɹjani
Bishan	biʃan
Blangah	blaŋga
Bobo	bobo
Boon	bun
Botanic	botɛnik
Boulevard	boləvad
Braddell	bɹɛdəl
Bras	bɹas
Bright	bɹa͡it
briyani	brijani
Buah	bua
Buangkok	buaŋkɔk
Bubur	b@b@ɹ
Bugis	bugis
bukit	buket
Buona Vista	buonavista
Bussorah	busora
by	ba͡i
cafes	kɛfɛs
cai	t͡sʰa͡i
Caldecott	kɛldəkɔt
Canai	ʃana͡i
Canberra	kɛnbəɹə
Canning	kɛniŋ
Cashew	kɛʃju
Casuarina	kɛʒərina
Cavan	kɛvən
Cecil	sisəl
ChaCha	t͡ʃat͡ʃa
Chai	t͡ʃa͡i
Chander	t͡ʃɛndə
Chandran	t͡ʃadɹan
Chang	ʒaŋ
Changi	t͡ʃaŋi
chap	d͡ʒap
char	ʧa
Chee	t͡ʃi
Chen	t͡ʃən
Chendol	t͡sɛndol
Cheng	t͡ʃeŋ
Cheong	t͡ʃiɔŋ
Cheow	t͡ʃia͡u
Chew	t͡ʃu
Chian	t͡ʃian
Chiang	t͡ʃiaŋ
Chim	t͡ʃim
Chin	t͡ʃin
Chinatown	t͡ʃa͡inəta͡un
Chinese	t͡ʃa͡inis
Ching	t͡ʃiŋ
choa	ʧua
Chong	t͡ʃɔŋ
Choon	t͡ʃun
Chor	t͡ʃɔ
Chow	t͡ʃa͡u
Choy	t͡ʃɔ͡i
chu	ʧu
Chuan	t͡ʃuan
Chwee	t͡ʃwi
Circle	səkəl
City	siti
Clarke	kla
Clementi	klɛmənti
Close	klos
Coast	kos
Commonwealth	kɔmənwɛlθ
Compassvale	kɔmpəsvel
Coniston	kɔnistən
Coral	kɔɹəl
Cove	kov
Craig	kɹeɡ
creaminess	kriminəs
Crescent	krɛsənt
Curry	kaɹi
dai	da͡i
Dakota	dakota
Damai	dama͡i
Dashreen	daʃɹin
decor	dɛkɔ
Deepak	dipak
Deepika	dipika
Desker	dɛskə
Dhal	dal
Dhoby Ghaut	dobigɔt
di	di
dim	tin
Dorset	dɔɹsɛt
Dou	dou
Dover	dovə
Downtown	da͡unta͡un
Drive	dra͡iv
dung	duŋ
Dunlop	danlop
Dunsfold	dansfold
Durian	djuɹiɛn
Duxton	dakstən
East	ist
Eber	ɛbə
Edge	ed͡ʒ
egg	eg
Elok	ɛlok
En	ən
Eng	eŋ
Erskine	əɹskain
Esplanade	ɛsplənad
Expo	ɛkspo
Faber	febə
Fajar	fad͡ʒa
Fan	fan
Farah	faɹa
Farmway	famwe
Farrer	fɛɹə
Fatimah	fatima
Fatt	fat
Fazirah	faziɹa
Fengshan	fəŋʃan
Fernvale	fənvel
Flanders	flɛndəs
Foch	fɔt͡ʃ
Folkestone	fəukstəun
Foo	fu
Fort	fɔt
Founders\	fa͡undəz
Fun	fan
fung	fɔŋ
gah	ga
gai	k̚ai
Gambir	gambiə
Ganges	grend͡ʒ
Gao	ka͡u
Garden	gadən
Gate	get
gau	ga͡u
Gemmill	gəmjul
Geylang	gelaŋ
Giam	kiam
glam	gəlam
gombak	gombak
gongfu	gɔŋfu
Gopal	gopal
Goreng	goɹɛŋ
Granges	gaŋəs
GRC	d͡ʒiarsi
Great	gɹet
Grove	grov
Gu	gu
Gu Zao Wei You Tiao	gu t͡sau wei jow tiau
Guang	guaŋ
Gul	gal
Gula	gula
Gunner	ganə
Guok	guok
Hae	he
Haikal	ha͡ikəl
Haji	had͡ʒi
hakka	haka
Halia	halia
Halifax	hɛlifɛks
Hall	hɔl
Ham	ham
Han	han
Hang	haŋ
Hao	ha͡u
Har	ha
Harbourfront	habəfɹan
Haresh 	haɹeʃ
Hastings	hɛstiŋs
Havelock	hɛvəlɔk
Haw	hɔ
Heights	ha͡its
Henderson	hɛndəsən
Heng	xəŋ
Hertford	həɹtfɔɹd
Hiang	hiaŋ
Highway	ha͡iwe
Hill	hil
Hillview	hilviu
Hindoo	hindu
Hitam	hitam
Hoe	ho
Hokkien	hɔkiɛn
Holland	hɔlən
Hong	hɔŋ
Hongkong	hɔŋkɔŋ
Hoon	hun
Hor	hɔ
horlicks	hɔliks
Horne	hɔn
Hougang	a͡ugaŋ
Hoy	hɔi
Hua	hua
Huan	huan
Huat	huat
Huay	we
Huda	huda
Huei	hue
Hui	hue
Huzaifi	huza͡ifi
Huzairi	huza͡iɹi
Hyderabad	ha͡idəɹəbad
Ibrahim	ibɹahim
ice	ais
Ikan	ikan
Ikmal	ikmal
Imran	imɹan
India	indiə
Indranee	indɹani
Iqbal	ikbal
Irfan	iɹfan
Irrawaddy	iɹawadi
Irving	əviŋ
istana	istanə
Jalan	d͡ʒalan
Jambol	d͡ʒambol
Jasim	d͡ʒasim
Java	d͡ʒava
Jebat	d͡ʒəbat
Jelapang	d͡ʒəlapaŋ
Jellicoe	d͡ʒɛliko
Jervois	d͡ʒərvɔ͡is
Ji	t͡ɕi
Jia	d͡ʒia
Jiak	d͡ʒiak
Jian	d͡ʒiɛn
jiang	dʒiang
Jiao	t͡ɕia͡u
Jie	d͡ʒiɛ
Jing	d͡ʒiŋ
John	d͡ʒɔn
Joo	d͡ʒu
Jun	d͡ʒun
Jurong	ʤuɹɔŋ
kacang	katʃaŋ
Kadaloor	kadaluɹ
Kah	ka
Kai	ka͡i
kakak	kakakʔ
kaki	kaki
kambing	kambeŋ
kampong	kampoŋ
Kandahar	kandəha
kang	kaŋ
Kangkar	kaŋka
Kapoor	kapuɹ
Karaage	ka. ra. ge
Katong	katɔŋ
Kay	kɛ
Kaya	kaja
Kayu	kaju
Keat	kiət
Kee	ki
Keerti	kəɹti
Kelantan	kəlantan
Kembangan	kəmbaŋan
Keng	kɛŋ
Kent	kɛnt
Keppel	kɛpəl
Kerbau	kəba͡u
Keris	kəris
Keropok	kəɹopok
Ketupat	kətupat
Kew	kiu
Kia	kia
Kiat	kiɛt
Killiney	kiləni
Kim	kim
King	kiŋ
Kio	kio
Kirk	kəɹk
Kit	kit
Kitchener	kit͡ʃənə
Koon	kun
kopi	k̚owp̚i
kosong	kosoŋ
Kovan	kovən
Kranji	kɹanʤi
Kreta	krɛta
Ku	ku
Kuala	kuala
kueh	kue
Kumar	kumaɹ
Kung	kəŋ
Kupang	kupaŋ
Kurau	kuɹa͡u
kut	kut
Kway	kwe
Labrador	lɛbɹədɔ
Lakeside	leksa͡id
laksa	lăɹ̆kʼsa
Lane	len
Lap	lap
lapis	laɹpis
Larut	laɹut
Laut	laut
Lavender	lɛvəndə
Lay	le͡i
Layar	laja
Lebar	leba
Lee	li
Lemak	ləmakʔ
Lembu	ləmbu
Lengkok	lɛŋkɔk
Lentor	lɛntɔ
Leong	liɔŋ
Leonie	liɔni
Lian	liɛn
Liang	liaŋ
Lim	lim
Limau	lima͡u
Ling	liŋ
Link	link
Little	litəl
Liu	liu
lo	lo
Loke	lɔk
long	lɔŋ
lontong	lontoŋ
Loop	lup
lor	lɔː
Lorong	lorɔŋ
Loyang	lojaŋ
Lua	lua
Mackerrow	mɛkəɹou
Macpherson	mɛkfəsən
Madras	madɹas
Maggie	mɛgi
mai	mai
Mak	mak
Mala	mala
Malan	malan
Malu	malu
Mantou	manto
Mao	ma͡u
Margaret	magərət
Marina	məɹina
Marine	məɹin
Marsiling	masəliŋ
Marymount	mɛɹima͡un
Mas	mas
masjid	masd͡ʒed
mati	mati
Mattar	mata
Maude	ma͡ud
Maxwell	mɛkswɛl
Mayam	majam
Mayflower	mefla͡uwə
Mayo	majo
McCallum	mɛkkeləm
mee	miː
Mei	mɛi
Melaka	məlaka
Melayu	məlaju
Memorial	məmɔɹiəl
Merah	mɛɹa
merepek	mərepeʔ
Mergui	mɛrgui
Meridian	məɹidiən
Merino	mərino
Mian	miɛn
milo	maɪlo
min	min
Ming	miŋ
Mo	mo
Mohamed	mohamad
Morse	moɹs
Mosque	mosk
Mount	ma͡unt
Mountbatten	ma͡unbɛtən
Muah	mua
Muhammed	Muhammed
Mui	Mui
Murray	məre
Murtabak	mətabak
Muthu	mutu
Naan	nan
Nabil	nabil
Nabilah	nabila
Nadia	nadia
Najib	nad͡ʒib
Nankin	nankin
Napier	nɛpiə
Nasi	nasi
Nauser	na͡usəɹ
Nazihah	naziha
Nee	ni
Newton	njutən
Ngoh	ŋɔ
Nibong	nibɔŋ
Nicoll	nikol
Nikita	nikita
Niven	nivən
Normanton	nɔrməntən
Norris	noɹis
North	nɔf
Novena	novina
Nur	nuɹ
Nyonya	njonja
o	o
Oasis	oesis
Ondeh	ɔnde
one-north	wannɔθ
Orchard	ɔt͡ʃəd
Orh	ɔ
Otah	ota
Outram	utrəm
padang	padaŋ
pagar	paga
Pagoda	pagoda
Pahang	pahaŋ
pahat	pahat
Palmer	pa͡umə
Panjang	pand͡ʒaŋ
pantat	pantat
Par	pa
Parade	pəɹed
Park	pak
pasir	pasə
Paya	paja
Payoh	pajo
Pei	pei
pek	peʔ
Pekin	pekin
Pending	pəndiŋ
peng	peŋ
Pengat	pəŋgat
penyet	peɪɲjɛt
Petir	pətiə
Phoenix	finiks
Piah	pia
Pie	pa͡i
Pier	piə
Ping	piŋ
Pioneer	pa͡iniə
Pipit	pipit
Piring	piɹiŋ
Pisang	pisaŋ
Place	ples
Pleasant	plɛzənt
Png	pəŋk
po	bo
Poh	po
Point	pɔint
Pok	pɔk
Pooja	pud͡ʒa
Popiah	popia
Potong	potoŋ
prata	p̚ɹaːɹːta
Preston	pɹɛstən
Prinsep	pɹinsɛp
Promenade 	pɹɔmənad
pulau	pulau
Pulut	pulut
Punggol	pɔŋgol
Purvis	pərvis
Puteh	putɛ
Putri	putɹi
Putu	putu
Qi	tɕʰi
Qian	tɕʰiɛn
Qing	tɕʰiŋ
Quay	kki
Queenstown	kwinsta͡un
Radhika	ɹadihika
Radin	radin
Raffles	ɹɛfəls
Raja	rad͡ʒa
Rajah	rad͡ʒa
Rajesh	ɹad͡ʒɛʃ
Ranggung	ɹaŋgɔŋ
Rangoon	ɹaŋgun
Rebus	bus
Redhill	ɹedhil
Ren	rən
rendang	rəndaŋ
Renjong	ɹənd͡ʒɔŋ
Reservoir	ɹɛsəvɔ
rezeki	rəzəki
Rhu	ɹu
Ridge	ɹiʤ
ris	rɪs
Riviera	ɹiviɛɹa
Rizwan	ɹizwan
Road	ɹod
Rochor	ɹot͡ʃo
rojak	ɹodʒaɹʔ
Rong	ɹɔŋ
Rotan	ɹotan
roti	ɹoti
Rou	ɹou
Rowell	ɹowɛl
Rui	rue
Rumbia	ɹumbia
Russels	ɹasəls
Sa	sa
Saba	sa. ba
Sago	sago
Sam	sam
sambal	sambal
Samudera	samudɛɹa
Sanjib	sand͡ʒib
satay	saɹ̆tei
Saunders	sɔndərs
Seah	sia
Segar	səga
Selegie	səligi
Sembawang	səmbawaŋ
Seng	sɛŋ
Sengkang	seŋkaŋ
Senja	sənd͡ʒa
sentosa	səntosə
Seow	sia͡u
Serangoon	ʃɛntən
Sha	ʃa
Shahirah	ʃahiɹa
shallot	ʃɛlət
shallots	ʃɛləts
Shan	ʃan
Shanmugam	ʃanmugam
Shao	ʃa͡u
Sharifah	ʃaɹifa
Sharma	ʃaɹma
Sheng	ʃəŋ
Shenton	ʃɛntən
Shreya	ʃɹeja
Shriya	ʃɹija
Si	si
Siak	siak
Siam	siam
Siang	siaŋ
siew	siu
Siglap	siglap
Simei	sime
Sinai	sina͡i
Sing	siŋ
Singh	siŋh
Siti 	siti
Sixth	siks
SMC	ɛsɛmsi
Somerset	saməsɜt
Soo	su
Sophia	sofia
Soto	soto
Sotong	sɔtɔŋ
sous	su
South	sa͡uθ
Springleaf	spɹiŋlif
Square	skuɛ
Srishti	sɹiʃti
Stadium	stediəm
Stevens	stivəns
Street	stɹit
Sturdee	stəɹdi
Suan	suan
sultan	sultan
sum	sam
Sumang	sumaŋ
Sungei	suŋa͡i
Suresh	suɹɛʃ
Suria	suria
Sussex	sasɛks
Syazwan	ʃazwan
Syed	sa͡id
Sze	sə
ta	da
tai	tai
tak	taʔ
Taman	taman
Tampines	tɛmpənis
Tan	tan
Tanah	tana
Tandoori	tandɔɹi
Tang	taŋ
tanjong	tandʒoŋ
Tarik	ɹik
Tat	tat
Tau	da͡uh
Taufik	ta͡ufik
Tauhu	ta͡uhu
Teck	tɛk
Tee	ti
teh	tei
﻿telok	təloʔ
Tempeh	tempe
Teng	teŋ
Teo	tio
Terrace	tɛɹəs
Thanggam	taŋgəm
the	θə
Thomson	tɔmsən
Thosai	tose
Tiam	tiam
Tian	tjan
Tiao	tiau
Tiong	tiɔŋ
Tng	təŋ
Toa	to
Toh	to
Tong	tɔŋ
Tongkang	Tongkang
Tow	ta͡u
tower	ta͡uə
Tras	tɹas
Trengganu	tɹɛŋganu
Truro	tɹuɹo
Tuas	tuas
Tuck	tak
Tutu	tutu
Ubi	ubi
Upper	apə
Vadai	vada͡i
Veerasamy	viɹasami
Verdun	vədən
vide	vid
View	viu
Vijaya	vid͡ʒaja
Villa	vila
Village	vileʤ
Walk	wɔk
Wan	wan
Wang	waŋ
Wanton	wantan
Watt	wat
Way	we
Wee	wikiɛt
Wei	wei
Wen	wən
West	wɛs
Weyhill	wejhil
Whye	wa͡i
Wilkie	wilki
Winstedt	winstet
Wishart	wiʃat
Woking	wokiŋ
Woodlands	wudləns
Woodleigh	wudle
World	wəl
Xian	siɛn
xiao	siau
Xilin	silin
Xin	sin
Xuan	Xuan
Yan	jɛn
Yang	jaŋ
Yati	jati
Yazid	jazid
Yee	i
Yew	ju
Yi	ji
Ying	jiŋ
Yio	jo
Yishun	iʃun
Yoke	jok
Yong	yɔŋ
You	ju
Yu	Yu
Yuan	juɛn
Yuhua	jhua
Yun	jun
Yusuf 	jusof
Zakirah	zakira
Zao	t͡sau
Zhe	t͡ʃə
Zheng	ʒəŋd͡ʒiɛn
Zhi	ʒə
Zhong	ʒoŋ
Zi	t͡sə
Zion	zion
Zuk	zuk
Zulfadli	zulfadli